NO ./Muri/NO.xpm
SO ./Muri/SO.xpm
WE ./Muri/WE.xpm
EA ./Muri/EA.xpm

F 220,100,0
C 225,30,0

        1111111111111111111111111
     	   100000000011000000000001
        10110000011100     000001
        1001000000000000000000001
111111111011000001110000E000000001
1000000000110000011101111 1111111
11110111111111011	100000010001
11110111111111011101010010001
110000001 10101011100000010001
100000000000000001100000010001
100 000000000	000011010100 00001
1100000111010101111101111000111
11110111 1110101 101111010001
11111111 1111111 111111111111
